

















































p
####################################################################





















                                                                                                                                                                       p

                                                                                                              ##################################################
                                                                                                              ##################################################

                                                                                                   #############################################################
                                                                                                   #############################################################

                                                                                        ########################################################################
                                                                                        ########################################################################

                                                                             ###################################################################################
                                                                             ###################################################################################

                                                                  ##############################################################################################
                                                                  ##############################################################################################

                                                        ########################################################################################################
                                                        ########################################################################################################

                                            ####################################################################################################################
                                            ####################################################################################################################
                                 
                                 ###############################################################################################################################
                                 ###############################################################################################################################

                      ########################################################################################################################################## 
                      ##########################################################################################################################################

           #####################################################################################################################################################
           #####################################################################################################################################################

################################################################################################################################################################
################################################################################################################################################################